Level 4
#### ####
#  ###  #
#  # $$ #
# $$ #  #
#    #  ##
### $.#  #
  #..*.@.#
  ##   ###
   #####